kais	v
mengais	v
mengais-ngais	v
mengaiskan	v
menyelinapkan	v
penyelinap	n
selinap	v
menyelinap	v
tiada	v
meniada	v
mempertiadakan	v
ketiadaan	n
sua	v
bersua	v
mempersuakan	v
tersua	v
persuaan	n
dalam	a|n
dalam-dalam	adv
berdalam-dalam	v
mendalam	v
mendalami	v
mendalamkan	v
dalaman	n
memperdalam	v
pedalaman	n
pendalaman	n
kedalaman	n|a
sedalam-dalamnya	adv
dunia	n
mendunia	a
keduniaan	n|a
sedunia	n
apa	pron|p
mengapa	pron
mengapai	v
mengapa-apai	v
mengapakan	v
dipengapakan	v
hati	n
berhati	v
sehati	n
sayang	a|v|n
menyayang	v
penyayang	n
kesayangan	n|a
tempat	n
bertempat-tempat	adv
tempatan	n
ketempatan	v
setempat	n
setempat-setempat	adv
bertempat	v
lama	a
berlama-lama	a
selama	n
selamanya	adv
selama-lamanya	adv
memperlama	v
awan	n
awan-berawan	n
berawan	v
mengawan	v
perawanan	n
jangan	adv
jangan-jangan	adv
jangankan	p
menjangankan	v
percaya	v
memercayai	v
memercayakan	v
tepercaya	a
kepercayaan	n
cedera	n
bercedera	v
percederaan	n
kecederaan	n
kata	n
berkata	v
berkata-kata	v
terkatakan	v
perkataan	n
memperkatakan	v
a	
b	
hanya	adv
tajam	a
mempertajam	v
mata	n
bermata	v
bermatakan	v
termata-mata	a
semata	n
semata-mata	adv
kepala	n
kepala-kepalaan	n
berkepala	v
mengepalai	v
mengepalakan	v
sujud	v
bersujud	v
tersujud	v
sanubari	n
mula	n
mula-mula	adv
bermula	v|adv
bermula-mula	adv
memula	v
memulakan	v
permulaan	n
pemula	n
semula	n|adv
sebermula	adv
segala	num
segalanya	adv
segala-galanya	adv
masa	n
semasa	n
semasa-masa	n|adv
kita	pron
kekitaan	n
ketika	n|p
seketika	adv
tiga	num
bertiga	num
pertiga	num
pertigaan	n
mempertiga	v
sepertiga	num
ketiga	num
ketiganya	num
ketiga-tiganya	num
tiga-tiganya	num
meramaikan	v
teramai	a
keramaian	n
ramai	v
a	v
beramai-ramai	v
di	p
waktu	n|p
berwaktu	v
pewaktuan	n
sewaktu	n
sewaktu-waktu	adv
tentu	a|adv
bertentu	v
bertentu-tentu	adv
menentu	v
menentui	v
menentukan	v
tertentu	a
penentu	n
penentuan	n
ketentuan	n
berketentuan	v
pandang	n
berpandangan	v
berpandang-pandangan	v
memandang	v
pandang-memandang	v
memandangi	v
terpandang	v
terpandang-pandang	v
pandangan	n
pemandang	n
pemandangan	n
sepemandangan	n
terang	a
berterang-terang	v
berterang-terangan	v
menerang	v
menerangi	v
menerangkan	v
penerangan	n
berpenerangan	v
keterangan	n
terang-terangan	n
penerang	n
kalau	p
kasih	n
berkasih	v
berkasih-kasihan	v
mengasihi	v
pekasih	n
pengasih	n
pengasihan	n
kekasih	n
dikau	pron
restu	n
merestui	v
pangku	v
berpangku	v
memangku	v
pemangku	n
pemangkuan	n
pangkuan	n
daku	pron
tiba	v
setiba	v
dua	num
berdua	num
berdua-dua	v
berduaan	v
perdua	v
memperdua	v
memperduai	v
memperduakan	v
seperdua	num
kaca	n
berkaca	v
berkaca-kaca	a
memperkaca	v
kekacaan	n
bahagia	n|a
berbahagia	a|v
membahagiakan	v
kebahagiaan	n
air	n
berair	v
mengairi	v
perairan	n
pengairan	n
berpengairan	v
keairan	v
mengaliri	v
mengalirkan	v
aliran	n
pengaliran	n
alir	v
mengalir	v
patah	a
mematah-matah	v
mematahkan	v
patahan	n
pematah	n
pematahan	n
buah	n
berbuah	v
membuahi	v
membuahkan	v
buah-buahan	n
perbuahan	n
pembuahan	n
bebuahan	n
kerja	n|v
bekerja	v
mengerjakan	v
mempekerjakan	v
tekerjakan	v
pekerja	n
pekerjaan	n
pengerjaan	n
sekerja	n
sepekerjaan	n
muka	n
bermuka	v
bermuka-muka	v|adv|num
permukaan	n
bersemuka	v
menyemukakan	v
mengemuka	v
mengemukakan	v
terkemuka	a
pengemukaan	n
pemuka	a|v
semuka	a|v
bunga	n
berbunga	v
berbunga-bunga	v
membunga	v
membungai	v
membunga-bungai	v
bunga-bungaan	n
perbungaan	n
cerca	n
mencerca	v
mencercai	v
cercaan	n
Melayu	n
lipu	a
senyum	n
menyenyumi	v
tersenyum	v
senyuman	n
harum	a
mengharum	v
mengharumi	v
mengharumkan	v
harum-haruman	n
keharuman	n
situ	pron|n
baru	a|adv
membaru	a
membarui	v
membarukan	v
terbaru	a
memperbarui	v
pembaru	n
pembaruan	n
kebaruan	n
sama	a
sama-sama	adv
bersama	v
bersama-sama	v
bersamaan	v
kebersamaan	n
membersamakan	v
persamaan	n
mempersamakan	v
mempersama-samakan	v
kesamaan	n
sesama	n
tersamai	v
rasa	n
rasanya	adv
rasa-rasanya	adv|v
berasa	v
merasa	v
merasai	v
merasa-rasai	v
merasakan	v
terasa	v
terasakan	v
perasa	n
memperasakan	v
perasaan	n
serasa	n
baca	v
membaca	v
membaca-baca	v
membacai	v
membacakan	v
terbaca	v
bacaan	n
pembaca	n
pembacaan	n
keterbacaan	n
tulis	v
bertulis	v
menulis	v
tertulis	v
tulisan	n
penulis	n
tulis-menulis	v
cuaca	n
rangkai	n
berangkai	v
berangkai-rangkai	v
merangkai	v
merangkaikan	v
rangkaian	v
perangkai	n
perangkaian	n
serangkai	n
menyerangkaikan	v
mutiara	n
mahkota	n
memahkotai	v
pemahkotaan	n
bermahkota	v
gapura	n
merelakan	v
kerelaan	n|adv
rela	v
v	v
merelai	v
dan	p
matahari	n
simpang	n
bersimpang	v
bersimpangan	v
menyimpang	v
simpangan	n
persimpangan	n
tiang	n
bertiang	v
ini	pron
mana	pron
mana-mana	pron
pernah	adv
bayang	n
berbayang	v
berbayang-bayang	v
membayang	v
terbayang	v
terbayang-bayang	v
bayangan	n
pembayangan	n
kejap	n
berkejap	v
berkejap-kejap	v
mengejap	v
sekejap	n
sini	pron
sinian	v|pron
mengesinikan	v
kesinian	v
iring	v
mengiring	v
mengiringkan	v
diiringkan	v
pengiring	n
suatu	num
bersuatu	v
mempersuatukan	v
sesuatu	pron
pasti	a
kepastian	n
susur	n
menyusur	v
menyusuri	v
susuran	n
penyusur	n
jalan	n|v|a
berjalan	v
berjalan-jalan	v
menjalani	v
menjalankan	v
jalanan	n|a
pejalan	n
perjalanan	n
sejalan	n
kesejalanan	n
resah	a
beresah-resah	v
meresah	v
meresahkan	v
keresahan	n|v
dari	p
sedari	p
demi	p
bisa	v
kebisaan	n
sebisanya	adv
cercah	n
secercah	n
cium	v
berciuman	v
mencium	v
mencium-cium	v
tercium	v
ciuman	n
pencium	n
penciuman	n
nikmat	a|n
menikmati	v
penikmat	n
penikmatan	n
kenikmatan	n
moga	adv
semoga	adv
sudah	adv
bersudah	v
bersudah-sudah	v
mempersudah	v
penyudah	n
sesudah	p
sesudah-sudah	p
sesudahnya	p
sesudah-sudahnya	adv
engkau	pron
berengkau	v
pun	p
pada	p
datang	v|n
datang-datang	adv|v
berdatangan	v
mendatang	v
mendatangi	v
datang-mendatangi	v
mendatangkan	v
pendatang	n
pendatangan	n
kedatangan	n
selamat	a|n
berselamatan	v
selamatan	n
penyelamat	n
keselamatan	n
anak	n
anak-anak	a|n
beranak	v
anak-beranak	n
anakan	n
anak-anakan	n
peranakan	n
memperanakkan	v
kulit	n
berkulit	v
mengulit	v
perkulitan	n
pengulit	n
api	n
berapi	v
berapi-api	a
mengapi	v
mengapi-apikan	v
perapian	n
memperapikan	v
kalbu	n
ganas	a
mengganas	v
pengganas	n
keganasan	n
bakar	v
membakar	v
dibakar	v
membakarkan	v
membakari	v
terbakar	v
pembakar	n
pembakaran	n
kebakaran	n|v
agak	n|adv
agaknya	adv
agak-agak	adv
beragak-agak	v
mengagak-agak	v
diagak	v
mengagakkan	v
teragak	v
seagak	adv
seagak-agak	adv
hangus	v
menghangus	v
menghanguskan	v
kehangusan	n|v
badan	n
berbadan	v
sebadan	n
bersebadan	v
menyebadani	v
seluruh	num
menyeluruh	v
keseluruhan	n
penuh	a
memenuhi	v
terpenuhi	v
pemenuhan	n
sepenuh	a
sabung	v
bersabung	v
menyabung	v
sabung-menyabung	v
menyabungkan	v
tersabung	v
sabungan	n
persabungan	n
penyabung	n
penyabungan	n
sinar	n
sinar-seminar	v
sinar-suminar	v
bersinar	v
menyinar	v
sinar-menyinar	v
sinaran	n
malam	n
malam-malam	n
bermalam	v
bermalam-malam	v
memalami	v
memalamkan	v
permalaman	n
mempermalamkan	v
pemalaman	n
kemalaman	v
semalam	n|adv
semalaman	n
semalam-malaman	n
picing	v
berpicing	v
memicing	v
memicingkan	v
terpicing	v
sepicing	n
gelisah	a
menggelisahi	v
menggelisahkan	v
kegelisahan	n
duduk	v
duduk-duduk	v
menduduki	v
mendudukkan	v
terduduk	v
penduduk	n
pendudukan	n
kedudukan	n
berkedudukan	v
sekedudukan	v
panjang	a|n
berpanjang-panjang	a
berkepanjangan	a
memanjang	v
memperpanjang	v
perpanjangan	n
pemerpanjangan	n
kepanjangan	n|a
sepanjang	n
cambuk	n
mencambuk	v
mencambuki	v
pencambukan	n
jiwa	n
berjiwa	v
menjiwai	v
kejiwaan	n
sentosa	a
bersentosa	v
kesentosaan	n
Allah	n
ke-Allah-an	n
Tuhan	n
bertuhan	v
bertuhankan	v
mempertuhan	v
mempertuhankan	v
ketuhanan	n
biar	p
membiarkan	v
memperbiar	v
nyala	n
bernyala	v
menyala	v
menyala-nyala	v
menyalakan	v
bernyala-nyala	v
tuju	v
tertuju	v
tujuan	n
bertujuan	v
setuju	n|v|a
bersetuju	v
menyetujui	v
menyetujukan	v
mempersetujukan	v
persetujuan	n
setujuan	n
bersetujuan	v
kesetujuan	n
anggap	v
menganggap	v
anggapan	n
beranggapan	v
kalap	a
kekalapan	n
jika	p
terjang	v
menerjang	v
menerjangkan	v
penerjangan	n
senjata	n
bersenjata	v
bersenjatakan	v
mempersenjatai	v
persenjataan	n
kesenjataan	n
sekutu	n
bersekutu	v
persekutuan	n
lengkap	a
berlengkap	v
berlengkapan	v
melengkapi	v
melengkapkan	v
perlengkapan	n
memperlengkapi	v
pelengkap	n
pelengkapan	n
kelengkapan	n
selengkap	a
kira	n
kira-kira	adv|n|v
berkira-kira	v
memperkirakan	v
terkira	v
terkirakan	v
kira-kiraan	n
perkiraan	n
kiraan	adv
sekira-kira	adv
kiranya	adv
sekiranya	adv
penekat	n
kenekatan	n
nekat	a
nekat-nekat	a
karena	p
dikarenakan	v
cuma	adv
cuma-cuma	adv
bercuma	v
percuma	adv
mempercumakan	v
bekal	n
berbekal	v
membekali	v
membekalkan	v
bekal-bekalan	n
perbekalan	n
pembekal	n
pembekalan	n
semangat	n
bersemangat	v
seteru	n
berseteru	v
perseteruan	n
memperseterukan	v
menghebatkan	v
hebat-hebatan	adv
memperhebat	v
kehebatan	n
hebat	v
menghebat	v
atau	p
lengan	n
mirip	a
bermiripan	v
kemiripan	n
kerangka	n
terkerangka	v
pengerangkaan	n
tengok-menengok	v
tengok	v
menengok	v
baja	n
berbaja	v
membaja	v
membajai	v
dada	n
berdada	v
berdada-dadaan	v
mendada	v
menyobek-nyobek	v
sesobek	n
sobek	v
menyobek	v
kain	n
berkain	v
merah	n|a
memerah	v
memerahi	v
memerahkan	v
pemerah	n
kemerahan	n
kemerah-merahan	a
putih	n|a
memutih	v
pemutih	n
keputihan	a|n
keputih-putihan	a
kibar	v
berkibar	v
berkibar-kibar	v
berkibaran	v
mengibarkan	v
mengibar-ngibarkan	v
kibaran	n
pengibar	n
pengibaran	n
dengar	v
berdengar	v
mendengar	v
mendengar-dengar	v
mendengarkan	v
terdengar	v
dengar-dengaran	v
memperdengarkan	v
pendengar	n
pendengaran	n
kedengaran	v
pekik	n
pekik-pekuk	v
memekik	v
memekikkan	v
terpekik	v
terpekik-pekik	v
pekikan	n
akbar	a
gaung	n
bergaung	v
gelegar	n
bergelegar	v
menggelegar	v
koyak	a
koyak-koyak	a
mengoyak	v
mengoyak-ngoyak	v
mengoyak-ngoyakkan	v
langit	n
melangit	v|a
selangit	n
murka	v
memurkai	v
kemurkaan	n
getar	n
menggetar	v
menggetarkan	v
penggetar	n
tiap	a
setiap	num
semua	num
semuanya	adv
semua-muanya	adv
jadi	v
menjadi	v
menjadikan	v
menjadi-jadi	v
menjadi-jadikan	v
terjadi	v
jadi-jadian	n
penjadi	n
penjadian	n
kejadian	n|v
sejadi-jadinya	adv
kecil	a
berkecil-kecil	v
berkecil-kecilan	v
mengecil	v
mengecilkan	v
kecil-mengecil	a
memperkecil	v
kecilan	a
kecil-kecilan	a
pengecilan	n
kekecilan	n|a
sekecil	a
tinggal	v
bertinggal	v
meninggal	v
tertinggal	v
tinggalan	n
ketertinggalan	n
pertinggal	n
peninggal	n
ketinggalan	n|v
upil	n
mengupil	v
gigil	a
menggigil	a
berani	a
keberanian	n
tidak	adv
tidak-tidak	adv
mempertidak	v
mempertidakkan	v
setidaknya	adv
setidak-tidaknya	adv
sakal	n
menyakal	v
negeri	n
muram	a
bermuram	v
memuramkan	v
kemuraman	n
liar	a
liaran	n
ombak	n
berombak	v
mengombak	v
laut	n
melaut	a|v
melauti	v
melautkan	v
lautan	n
pelaut	n
pelautan	n
kelautan	n
musafir	n
tak	adv
tahu	v
tahu-tahu	adv
bertahu-tahu	v
bertahuan	v
bertahukan	v
tahu-menahu	v
mengetahui	v
pengetahuan	n
berpengetahuan	v
ketahuan	v
setahu	adv
badai	n
berbadai	v
membadai	v
keluar	v
mengeluari	v
mengeluarkan	v
keluaran	n
pengeluaran	n
mengerami	v
mengeramkan	v
pengeram	n
pengeraman	n
eram	v
mengeram	v
batu	n
berbatu	v
berbatu-batu	num
membatu	v
membatui	v
batuan	n
berbatuan	a
pembatuan	n
karang	n
mengarang	v
karangan	n
karang-karangan	n
berkarang	v
permai	a
kepermaian	n
kapal	n
berkapal	v
perkapalan	n
jauh	a
menjauh	v
menjauhkan	v
diri	n
burung	n
burung-burungan	n
gagak	n
sarang	n
bersarang	v
bersarang-sarang	v
menyarangkan	v
muara	n
bermuara	v
sungai	n
unggas	n
mengunggas	v
bagai	n|p
berbagai	v
berbagai-bagai	v
keberbagaian	n
bagaikan	p
membagaikan	v
memperbagai-bagaikan	v
sebagai	p|adv
pergi	v
bepergian	v
kepergian	n
entah	adv
entah-berentah	a
untuk	p
beruntuk	v
menguntukkan	v
teruntuk	v
peruntukan	n
memperuntukkan	v
nelayan	n
tambang	n
menambang	v
pertambangan	n
atas	n
mengatas	v
mengatasi	v
atas-mengatasi	v
mengataskan	v
teratasi	v
atasan	n
sembur	n
menyembur	v
menyemburkan	v
penyembur	n
asap	n
berasap	v
berasap-asap	v
mengasap	v
mengasapi	v
perasapan	n
pengasapan	n
cipta	n
mencipta	v
menciptakan	v
pencipta	n
jenaka	a
berjenaka	v
kejenakaan	n
badut	n
membadut	v
sandiwara	n
bersandiwara	v
dengan	p
cangklong	n
besar	a
besar-besaran	a
berbesar-besar	v
membesar	v
membesarkan	v
membesar-besar	v
membesar-besarkan	v
terbesar	a
memperbesar	v
pembesar	n
pembesaran	n
kebesaran	n
ocehan	n
oceh	v
mengoceh	v
batuk	n|v
batuk-batuk	n
berbatuk	v
terbatuk-batuk	v
keras	a
berkeras	v
berkeras-kerasan	v
mengeras	v
mengerasi	v
keras-mengerasi	v
mengeraskan	v
memperkeras	v
pengeras	n
pengerasan	n
kekerasan	n
bersikeras	v
orang	n
berorang-orang	v
perseorangan	n
seorang	n
keseorangan	n
seseorang	n
wartawan	n
kewartawanan	n
pengindonesiaan	n
keindonesiaan	n
Indonesia	v
mengindonesiakan	v
adalah	v
berita	n
berberita	v
memberitakan	v
pemberita	n
pemberitaan	n
bahasa	n
berbahasa	v
berbahasa-bahasa	a
membahasakan	v
perbahasa	n
perbahasaan	n
memperbahasakan	v
kebahasaan	n
kacau	a|v
mengacau	v
memperkacaukan	v
terkacau	v
kacauan	n
pengacau	n
kekacauan	n
berkacau	v
huruf	n
berhuruf	v
muda	a
bermuda	v
bermuda-muda	v
memudakan	v
termuda	a
mempermuda	v
pemuda	n
kemudaan	n|a
kemuda-mudaan	n
kepemudaan	n
undur	v
mengundur	v
mengundurkan	v
pengunduran	n
simpan	v
menyimpan	v
tersimpan	v
simpanan	n
penyimpan	n
pendokumentasian	n
dokumentasi	v
mendokumentasikan	v
kincir	n
berkincir	v
kinciran	n
angin	n
berangin	v
angin-angin	n|a
berangin-angin	v
mengangin	v
mengangini	v
menganginkan	v
mengangin-anginkan	v
terangin	v
terangin-angin	v
angin-anginan	a
peranginan	n
memperanginkan	v
keanginan	v
seangin	n
seperti	p
sepertikan	p
sepertinya	p|adv
sayap	n
bersayap	v
merpati	n
penyap	a
sebar	v
menyebar	v
menyebarkan	v
penyebar	n
lelap	v
melelapkan	v
terlelap	v
ke	p
pupuk	n
memupuk	v
dipupuk	v
terpupuk	v
pemupuk	n
bagi	p
udara	n
mengudara	v
mengudarakan	v
pengudaraan	n
lihat	v
melihat	v
melihat-lihat	v
melihati	v
melihatkan	v
terlihat	v
memperlihatkan	v
pelihat	n
penglihat	n
penglihatan	n
kelihatan	v
kelihatannya	adv
hutan	n
menghutan	v
menghutankan	v
perhutanan	n
penghutanan	n
kehutanan	n
sawah	n
bersawah	v
menyawah	v
persawahan	n
penyawah	n
pesawah	n
ratus	n
beratus-ratus	num
ratusan	num
peratus	num
menyeratus	v
perseratus	num
lintas	n
melintas	v
melintasi	v
pelintas	n
selintas	n
jembatan	n
menjembatani	v
terjembatani	v
penjembatanan	n
belum	adv
belum-belum	adv
sebelum	adv
selesai	v
terselesaikan	v
selesaian	n
keselesaian	n
bikin	v
membikin	v
membikin-bikin	v
terbikin	v
bikinan	n
pembikinan	n
sudut	n
menyudut	v
tersudut	v
belakang	n
berbelakang-belakangan	v
membelakang	v
membelakangi	v
membelakangkan	v
memperbelakangkan	v
terbelakang	a
keterbelakangan	n
belakangan	n
mengebelakangkan	v
terkebelakang	a
pembelakangan	n
peta	n
terpeta	v
perpetaan	n
petaan	n
ular	n
ular-ularan	n
mengular	v
memang	adv
sememangnya	adv
tumbuh	v
bertumbuh	v
bertumbuhan	v
menumbuh	v
tumbuhan	n
tumbuh-tumbuhan	n
pertumbuhan	n
mempertumbuhkan	v
penumbuh	n
ketumbuhan	v|n
tetumbuhan	n
subur	a
penyubur	n
kesuburan	n
tumpuk	n|v
bertumpuk-tumpuk	v
menumpuk	v
tertumpuk	v
tumpukan	n
penumpukan	n
jerami	n
basah	a
berbasah-basah	v
membasahi	v
membasahkan	v
basahan	n
pembasahan	n
kebasah-basahan	a
minyak	n
berminyak	v
berminyak-minyak	v
meminyaki	v
perminyakan	n
tanah	n
bertanah	v
mengetanahkan	v
pertanahan	n
menumpukkan	v
setumpuk	n
unggun	n
berunggun	v|a
berunggun-unggun	v
mengunggun	v
mengunggunkan	v
unggunan	n
barbar	a
buku	n
membukukan	v
perbukuan	n
pembukuan	n
sedang	adv
kantor	n
berkantor	v
perkantoran	n
terima	v
berterima	v
keberterimaan	n
menerima	v
menerimakan	v
penerima	v
penerimaan	n
tenaga	n
bertenaga	v
ketenagaan	n
deret	
berderet	v
deretan	n
gerbong	n
kereta	v
berkereta	v
debu	n
berdebu	v
mendebu	v
kaki	n
ki	
berkaki	v
kening	n
mulut	n
bermulut	v
bermulut-mulut	v
mulut-mulutan	n
mengangakan	v
ternganga	v
nganga	v
menganga	v
tatkala	p
bencana	n
membencanai	v
membencanakan	v
damprat	v
mendamprat	v
dampratan	n
perut	n
berperut	v
memeruti	v
seperut	num
berapa	pron
bank	n
perbankan	n
modal	n
bermodal	v
bermodalkan	v
memodali	v
permodalan	n
pemodal	n
asing	a
berasing	v
berasing-asingan	v
mengasing	v
mengasingkan	v
terasing	v
perasingan	n
pengasingan	n
keasingan	n
dekat	a
dekat-dekat	adv
berdekat	v
berdekat-dekat	v
berdekatan	v
mendekat	v
mendekati	v
mendekatkan	v
terdekat	a
memperdekat	v
memperdekatkan	v
pendekatan	n
kedekatan	n
tua	a
tua-tua	n|a
tetua	n
bertua-tua	v
bertua-tuaan	v
tertua	n
pengetua	n
ketuaan	a|n
ketua-tuaan	a
malaikat	n
celaka	v
mencelakai	v
mencelakakan	v
kecelakaan	n|v
lagu	n
berlagu	v
melagu	v
melagui	v
melagukan	v
laguan	n
pelagu	n
arti	n
berarti	v
keberartian	n
mengartikan	v
artian	n
pengartian	n
searti	n
apa-apa	n
apa-apaan	pron
hewan	n
kehewanan	n
jenguk	v
menjenguk	v
menjengukkan	v
gua	n
rimba	n
merimba	v
perimba	n
raya	a
merayakan	v
perayaan	n
berisik	a
menuju	v
menujui	v
menujukan	v
penuju	a|n
jalin	v
berjalin	v
berjalin-jalin	v
jalin-berjalin	v
berjalinan	v
menjalin	v
jalin-menjalin	v
menjalinkan	v
terjalin	v
jalinan	n
penjalinan	n
alun-alun	n
tikung	v
menikung	v
puluh	n
berpuluh-puluh	num
puluhan	n|num
perpuluhan	n
persepuluhan	n
gembira	a
bergembira	v
menggembirakan	v
mempergembirakan	v
penggembira	n
kegembiraan	n
mayat	n
masuk	v
memasuki	v
toko	n
bertoko	v
pertokoan	n
pasar	n|a
pasaran	n|a
pemasar	n
barang	n
rajin	a
perajin	n
kerajinan	n
keperak-perakan	a
perak	a
keperakan	a
emas	n
beremas	v
mengemas	v
mengemasi	v
mengemaskan	v
peremasan	n
keemasan	n
tiru	v
tiruan	n
tiru-tiruan	v
tampung	v
menampung	v
penampung	n
penampungan	n
para	p
penganggur	n
pengangguran	n
anggur	v
menganggur	v
atap	n
beratap	v
beratapkan	v
mengatap	v
mengatapi	v
pengatapan	n
bocor	v
membocorkan	v
bocoran	n
pembocoran	n
kebocoran	n
administrasi	n
jaga	v
berjaga	v
berjaga-jaga	v
menjaga	v
menjagakan	v
terjaga	v
penjaga	n
penjagaan	n
kejaga-jagaan	v
oleh	
beroleh	v
perolehan	n
memperoleh	v
pemerolehan	n
anjing-anjing	n
malas	a
malas-malasan	v
bermalas-malas	v
memalaskan	v
pemalas	n
kemalasan	n|a
berantukan	v
mengantuk	v
mengantukkan	v
terantuk	v
antuk	v
berantuk	v
kamus	n
pekamus	n
perkamusan	n
bendahara	n
perbendaharaan	n
ruwet	a
meruwetkan	v
keruwetan	n
bolak-balik	v|a
berbolak-balik	v
membolak-balikkan	v
ambil	v
berambil-ambil	v
mengambil	v
ambil-mengambil	v
mengambili	v
mengambilkan	v
terambil	v
ambilan	n
pengambil	n
pengambilan	n
lagi	adv|p
lagi-lagi	adv
lagian	adv
selagi	adv
sampai	v
menyampai	v
tersampaikan	v
penyampai	n
kesampaian	v
berkesampaian	v
sesampai	v
sampai-sampai	adv
bengkak	a
membengkak	v
pembengkakan	n
seru	n
berseru	v
berseru-seru	v
seruan	n
bilang	v
berbilang	v
membilang	v
membilangkan	v
terbilang	v
bilangan	n
pembilang	n
pembilangan	n
kebilangan	n
sebilang	num
sebilangan	num
benda	n
berbenda	v
membendakan	v
perbendaan	n
pembendaan	n
kebendaan	n
ulang	v
ulang-ulang	v|n
berulang	v
berulang-ulang	v
mengulang	v
mengulang-ulang	v
mengulangi	v
terulang	v
ulangan	n
perulangan	n
pengulang	n
pengulangan	n
seulang	adv
sifat	n
bersifat	v
tersifatkan	v
sambung	v
bersambungan	v
menyambung	v
sambungan	n
persambungan	n
mempersambungkan	v
penyambung	n
bersambung	v
sambung-bersambung	v
ia	v
sambung-menyambung	v
mimpi	n
bermimpi	v
memimpikan	v
termimpi-mimpi	v
mimpian	n
pemimpi	n
sekolah	n
bersekolah	v
sekolahan	n
persekolahan	n
jual	v
berjual	v
berjualan	v
menjual	v
dijual	v
menjuali	v
menjualkan	v
terjual	v
jualan	n|v
penjual	n
penjualan	n
bawa	v
membawa	v
membawa-bawa	v
membawakan	v
terbawa	v
bawaan	n
berbawaan	v
pembawa	n
pembawaan	n
berpembawaan	v
sepembawa	n
sesak	a
bersesak-sesak	v
menyesak	v
sesak-menyesak	v
tersesak	v
kesesakan	n
putus	v
putus-putus	adv
berputusan	adv
memutus	v
terputus	v
terputus-putus	adv
terputuskan	v
putusan	n
pemutus	n
keputusan	n
berkeputusan	v
ular-ular	n
lapar	a
berlapar	a
melaparkan	v
kelaparan	n|v
bumi	n
membumi	v
mengebumikan	v
rusak	a
berusak	v
merusak	v
merusaki	v
perusak	n
kebun	n
berkebun	v
memperkebuni	v
memperkebunkan	v
pekebun	n
perkebunan	n
indah	a
memperindah	v
pengindah	n
terindah	a
keindahan	n
teluk	n
selalu	adv
buru	v
berburu	v
berburu-buru	v
memburu	v
memburu-buru	v
memburu-burukan	v
terburu	v
terburu-buru	v
buruan	n
perburuan	n
pemburu	n
pemburuan	n
keburu	v
pantai	n|a
memantai	v
siang	n
siang-siang	a
kesiangan	v|a
kunjung	v
berkunjung	v
berkunjung-kunjungan	v
kunjungan	n
pengunjung	n
henti	n
berhenti	v
memberhentikan	v
pemberhentian	n
menghentikan	v
terhenti	v
terhentikan	v
hentian	n
perhentian	n
memperhentikan	v
penghenti	n
penghentian	n
intai	v
mengintai	v
mengintaikan	v
pengintai	n
pengintaian	n
barangkali	adv
sembunyi	v
bersembunyi-sembunyi	a
sembunyi-sembunyian	v
bersembunyi	v
bersembunyi-sembunyian	v
tersembunyi	v
persembunyian	n
ki	adv
sembunyi-sembunyi	adv
namun	p
tahan	a
bertahan	v
bertahan-tahan	v
menahan	v
menahankan	v
tertahan	v
tertahan-tahan	v
tahanan	n
pertahanan	n
mempertahankan	v
penahan	n
penahanan	n
ketahanan	n
menahani	v
rumpun	n
berumpun	v
berrumpun-rumpun	v
merumpun	v
serumpun	n
bakau	n
derai	n
berderai	v
jangkau	n
menjangkau	v
terjangkau	v
jangkauan	n
sejangkauan	n
sepenjangkauan	n
gulung	n
bergulung	v
bergulung-gulung	n|v
menggulung	v
gulung-menggulung	v
tergulung	v
gulungan	n
penggulungan	n
gelora	n
bergelora	v
menggelora	v
menggelorakan	v
haram	a
mengharamkan	v
pengharaman	n
diam	v
diam-diam	adv
berdiam	v
mendiamkan	v
terdiam	v
pendiam	n
kependiaman	n
merenungi	v
renung	v
merenung	v
terus	v
menerus	v
terus-menerus	adv
meneruskan	v
terusan	n
terus-terusan	adv
penerus	n
penerusan	n
keterusan	n
seterusnya	adv
amuk	n
beramuk	v
beramuk-amuk	v
beramuk-amukan	v
mengamuk	v
mengamukkan	v
amukan	n
pengamuk	n
pengamukan	n
rindu	a
merindu	v
merindukan	v
rinduan	n
perindu	n
kerinduan	n
dendam	a
berdendam	v
berdendam-dendaman	v
mendendam	v
mendendami	v
mendendamkan	v
pendendam	n
kedendaman	n
alwasi	n
itu	pron
itulah	pron
gamang	a
tergamang	v
penggamang	n
suka	a|v
suka-suka	adv
bersuka-suka	v
bersuka-sukaan	v
sukaan	n
kesukaan	n
sesuka	a
sesuka-suka	a
sesukanya	adv
sesuka-sukanya	adv
gambar	n
bergambar	v
menggambar	v
tergambar	v
gambaran	n
penggambar	n
penggambaran	n
ragu	a
ragu-ragu	a
meragukan	v
mengembarai	v
pengembara	n
pengembaraan	n
embara	v
mengembara	v
risau	a
merisau	v
perisau	n
falsafi	a
depan	n
berdepan-depan	v
terdepan	a|p
mengedepankan	v
pengedepanan	n
suram	a
suram-suram	a
menyuram	v
kesuraman	n
cerah	a
pencerahan	n
kecerahan	n
terlalu	adv
keterlaluan	adv
kepada	p
tatap	v
bertatapan	v
bertatap-tatapan	v
menatap	v
menatapi	v
tatapan	n
penatapan	n
fana	a
memfanakan	v
kefanaan	n
jamah	v
menjamah	v
terjamah	v
jamahan	n
jamah-jamahan	n
penjamah	n
penjamahan	n
bahwa	p
hidup	v
menghidupi	v
menghidupkan	v
memperhidup	v
penghidupan	n
kehidupan	n
langkah	n
berlangkah	v
melangkah	v
melangkahi	v
melangkahkan	v
terlangkahkan	v
perlangkahan	n
pelangkah	n
pelangkahan	n
kelangkahan	v|n
selangkah	n
terkadang	adv
terkadang-kadang	adv
kadang	adv
kadang-kadang	adv
pasrah	v
berpasrah	v
kepasrahan	n
antara	n|p|a
berantara	v
mengantara	v
mengantarai	v
memperantarai	v
perantara	n
perantaraan	n
pengantara	n
pengantaraan	n
belalang	n
isi	n
mengisi	v
mengisikan	v
pengisi	n
pengisian	n
tembolok	n
kenyang	a
mengenyangkan	v
kekenyangan	n|a
sekenyangnya	adv
sekenyang-kenyangnya	adv
ayam	n
ayam-ayam	n
ayam-ayaman	n
musang	n
rahang	n
buaya	n
membuaya	v
membuayai	v
tolak	v
bertolak	v
bertolak-tolak	v
bertolak-tolakan	v
menolak	v
tolak-menolak	v
menolakkan	v
tertolak	v
tolakan	n
penolak	n
penolakan	n
bangkai	n
darat	n
mendarat	v
mendarati	v
mendaratkan	v
daratan	n
pendarat	n
pendaratan	n
ancam	v
mengancam	v
mengancamkan	v
terancam	v
ancaman	n
pengancam	n
pengancaman	n
hayat	n
menghayati	v
penghayat	n
penghayatan	n
mau	adv|n
memau-mau	v
memaui	v
memaukan	v
kemauan	n
semau	v
semau-maunya	adv|p
maupun	p
capai	v
mencapai	v
tercapai	v
capaian	n
pencapai	n
pencapaian	n
sepencapai	v
maka	p
halang	v
menghalang	v
berhalangan	v
menghalangi	v
menghalang-halangi	v
terhalang	v
halangan	n
penghalang	n
nilai	n
bernilai	v
menilai	v
ternilai	v
penilai	n
penilaian	n
asal	n|a
berasal	v
mengasalkan	v
sendiri	adv|a|n
sendiri-sendiri	adv
bersendiri	v
menyendiri	v
tersendiri	v
sendirian	pron
penyendiri	n
kesendirian	n|adv
menang	v
memenangi	v
memenangkan	v
mempermenangkan	v
pemenang	n
pemenangan	n
kemenangan	n
dapat	adv|v
berdapat	v
mendapat	v
mendapati	v
mendapatkan	v
terdapat	v
dapatan	n
memperdapat	v
pendapat	n
pendapatan	n
kedapatan	v
sedapat	v
sedapat-dapatnya	adv
sahabat	n
bersahabat	v
persahabatan	n
mempersahabatkan	v
anyam	v
menganyam	v
anyam-menganyam	v
anyaman	n
rapat	a
merapat	v
merapati	v
merapatkan	v
rapatan	n
perapat	n
memperapat	v
kerapatan	n
pagar	n
berpagar	v
memagar	v
curiga	n
senja	n
kesenjaan	v
nyata	a
menyatakan	v
ternyata	v
ternyatakan	v
pernyataan	n
kenyataan	n
tari	n
bertari	v
tarian	n
tari-tarian	n
gemulai	a
menggemulai	v
suara	n
bersuara	v
gamelan	n
alun	n
beralun	v
beralun-alun	v
mengalun	v
mengalunkan	v
teralun	v
alunan	n
hampa	a
menghampakan	v
kehampaan	n
bawah	n|v
membawahi	v
membawahkan	v
terbawah	a
bawahan	n
sebawah	n
sebawahan	n
gelap	a
gelap-gelapan	adv|v
bergelap-gelap	v
menggelap	v
menggelapkan	v
penggelapan	n
kegelapan	v|n|a
kegelap-gelapan	a
mengendap	v
mengendapkan	v
endapan	n
terendapkan	v
pengendapan	n
endap	n
endap-endap	n
cari	v
bercari	v
bercari-cari	v
bercari-carian	v
mencari	v
mencari-cari	v
mencarikan	v
tercari	v
carian	n
cari-carian	v
pencari	n
pencarian	n
telah	adv
setelah	adv
begitu	pron
membegitukan	v
begituan	pron
sebegitu	num
banyak	a|num|adv
banyak-banyak	a
berbanyak	v
berbanyak-banyak	v
membanyak	v
membanyaki	v
membanyakkan	v
terbanyak	a
banyakan	a
perbanyakan	n
memperbanyak	v
memperbanyakkan	v
kebanyakan	n
sebanyak	num
peristiwa	n
berperistiwa	v
rahasia	n|a
berahasia	v
merahasiakan	v
rahasia-rahasiaan	v
kerahasiaan	n
satu	num
satu-satu	adv
bersatu	v
satuan	n
persatuan	n
mempersatukan	v
pemersatu	n
pemersatuan	n
kesatu	num
kesatuan	n
satu-satunya	a
segi	n
persegi	v|n
bersegi	v
saja	adv
bagi	n
berbagi	v
membagi	v
terbagi	v
pembagi	n
tetap	v|a|adv
menetap	v
mempertetap	v
mempertetapkan	v
ketetapan	n
berketetapan	v
gulita	a|n
berteka-teki	v|n
hilang	v
hilang-hilang	v
menghilang	v
menghilangkan	v
kehilangan	n|v
penghilangan	n
soal	n
bersoal	v
mempersoalkan	n
persoalan	n
dinding	n
berdinding	v
mendinding	v
mendindingi	v
terdinding	v
pendinding	n
pendindingan	n
kukuh	a
berkukuh	v
memperkukuh	v
kekukuhan	n
perkasa	a
keperkasaan	n
manusia	n
memanusiakan	v
pemanusiaan	n
kemanusiaan	n
sumber	n
bersumber	v
kembang	v
berkembang	v
perkembangan	n
kembangan	n
pengembangan	n
teknologi	
temu	v
menemu	v
menemukan	v
tertemukan	v
mempertemukan	v
penemu	n
komputer	n
hasil	n|v
menghasilkan	v
penghasil	n
lelaki	n
pinggir	n
meminggir	v
terpinggirkan	v
pinggiran	n
peminggir	n
kepinggiran	a
nasib	n
nasib-nasiban	v
senasib	n
bernasib	v
hilir	n
berhiliran	v
menghilir	v
menghiliri	v
menghilirkan	v
sehilir	n
bertemu	v
temuan	n
pertemuan	n
erti	n
mengerti	v
mengertikan	v
pengertian	n
ufuk	n
berufuk	v
kelabu	n
mengelabui	v
pengelabuan	n
kuala	n
berkuala	v
buka	v
membuka	v
membukakan	v
terbuka	v
pembuka	n
pembukaan	n
keterbukaan	n
membukai	v
berangkat	v
memberangkatkan	v
pemberangkatan	n
keberangkatan	n
kembali	v
mengembalikan	v
pengembalian	n
kembalian	n
saat	n
sesaat	n
arus	n
mengarus	v
hingga	n|p
berhingga	v
menghinggakan	v
terhingga	v
perhinggaan	n
memperhinggakan	v
diri	v
berdiri	v
mendirikan	v
terdiri	v
pendiri	n
pendirian	n
berpendirian	v
luput	v
meluputkan	v
terluput	v
genggam	n
bergenggam	a
menggenggam	v
tergenggam	v
genggaman	n
gunung	n
gunung-ganang	n
gunung-gemunung	n
bergunung-gunung	v
menggunung	v
gunungan	n
gunung-gunungan	n
pegunungan	n
bangun	v
membangun	v
membanguni	v
membangunkan	v
kebangunan	n
tugu	n
lampu	n
berlampu	v
perlampuan	n
acuh	v
mengacuhkan	v
acuhan	n
gapai	v
bergapaian	v
menggapai	v
menggapai-gapai	v
menggapai-gapaikan	v
tergapai	v
tergapai-gapai	v
bangsa	n
berbangsa	v
membangsa	v
membangsakan	v
kebangsaan	n
sebangsa	n
mengombang-ambingkan	v
terombang-ambing	v
ombang-ambing	v
mengombang-ambing	v
cermin	n
becermin	v
bercermin	v
mencermini	v
mencerminkan	v
tercermin	v
cerminan	n
mempercermin	v
sana	pron
kejar	v
berkejaran	v
bersikejar	v
berkejar-kejaran	v
mengejar	v
dikejar	v
mengejar-ngejar	v
kejar-mengejar	v
mengejarkan	v
terkejar	v
terkejar-kejar	v
kejaran	n
pengejaran	n
gairah	n
bergairah	v
menggairahkan	v
kegairahan	n
mengesokkan	v
keesokan	n
esok	adv
beresok	adv
kian	n|adv
berkian-kian	num
sekian	n
memperelok	v
keelokan	n
seelok	a
seelok-eloknya	adv
elok	v
mengelokkan	v
tonton	v
menonton	v
menontonkan	v
tontonan	n
mempertontonkan	v
penonton	
kepenontonan	n
topeng	
bertopeng	v
mempertopeng	v
istana	n
musim	n
bermusim	v
musiman	v
panas	a|n
panas-panas	a
berpanas	v
berpanas-panas	v
memanas	v
terpanasi	v
pemanas	n
kepanasan	n|v|a
kenang	v
mengenang	v
mengenangkan	v
terkenang	v
kenangan	n
kenang-kenangan	n
betapa	pron|p
musik	n
bermusik	v
memusiki	v
memusikkan	v
musikan	v
permusikan	n
pemusik	n
tubuh	n
bertubuh	v
pertubuhan	n
setubuh	n
bersetubuh	v
menyetubuhi	v
persetubuhan	n
sandar	v
bersandar	v
bersandarkan	v
menyandar	v
sandar-menyandar	v
menyandari	v
menyandarkan	v
tersandar	v
sandaran	n
persandaran	n
pesandaran	n
penyandar	n
penyandaran	n
lemas	a
melemaskan	v
degung	n
ha	v
tinggi	a
meninggi	v
tertinggi	a
mempertinggi	v
petinggi	n
ketinggian	n|a
milik	n
memiliki	v
termilik	v
pemilik	n
pemilikan	n
kemilikan	n
kepemilikan	n
sia-sia	a
bersia-sia	v
tersia-sia	n
kesia-siaan	n
rawat	v
merawat	v
merawatkan	v
terawat	v
rawatan	n
perawat	n
perawatan	n
keperawatan	n
macam	n|p
macam-macam	adv
bermacam	a
bermacam-macam	a
mempermacam-macamkan	v
semacam	a
perahan	n
pemerahan	n
perah	v
mesti	adv
memestikan	v
kemestian	n
semestinya	adv
kurban	n
mengurbankan	v
nyawa	n
bernyawa	v
senyawa	n
bersenyawa	v
senyawaan	n
persenyawaan	n
kerbau	n
halau	v
menghalau	v
penghalau	n
penghalauan	n
bantai	n
membantai	v
bantaian	n
pembantai	n
pembantaian	n
membolehkan	v
bolehan	a
memperbolehkan	v
kebolehan	n
seboleh-bolehnya	adv
boleh	
kendati	p
kendatipun	p
kuak	n
menguak	v
cemeti	n
mencemeti	v
mendera	a
dewa	
mendewakan	v
mendewa-dewakan	v
memperdewa	v
memperdewakan	v
pendewaan	n
kedewaan	n
cabut	v
mencabut	v
bercabut	v
mencabuti	v
mencabutkan	v
tercabut	v
cabutan	n
pencabut	n
pencabutan	n
bermewah-mewahan	v
kemewahan	n
mewah	v
nafsu	n
bernafsu	v
luas	a
meluas	v
meluaskan	v
memperluas	v
perluasan	n
peluasan	n
keluasan	n
luasan	n
deru	n
menderu	v
menderu-deru	v
gelombang	n
bergelombang	v
menggelombang	v
sedia	v
menyediakan	v
mempersediakan	v
penyedia	n
kenal	v
berkenalan	v
berkenal-kenalan	v
mengenal	v
kenal-mengenal	v
mengenali	v
memperkenalkan	v
terkenal	v
kenalan	n
perkenalan	n
pengenal	n
pengenalan	n
daki	v
mendaki	v
mendakikan	v
terdaki	v
dakian	n
pendaki	n
pendakian	n
turun	v
menurun	v
menuruni	v
penurun	n
jurang	n
sakit	a
sakit-sakitan	v
mempersakiti	v
penyakit	n
pesakitan	n
kesakitan	a|n
bersakit-sakit	v
lelah	a
melelahkan	v
memperlelah	v
kelelahan	a
kubur	n
berkubur	v
mengubur	v
kuburan	n
terkubur	v
pekuburan	n
jenak	n
sejenak	n
membaringkan	v
terbaring	v
pembaringan	n
baring	v
berbaring	v
pilih	v
memilih	v
memilih-milih	v
terpilih	v
pilihan	n
pilih-pilih	v
berpilih-pilih	v|a
pemilih	n
angkat	v|a
mengangkat	v
mengangkat-angkat	v
mengangkati	v
mengangkatkan	v
terangkat	v|n
angkatan	n
perangkat	n
perangkatan	n
pengangkat	n
pengangkatan	n
seangkatan	n
seperangkat	n
seperangkatan	n
nobat	v
menobatkan	v
ipar	n
beripar	v
mertua	n
saudara	n
bersaudara	v
persaudaraan	n
mempersaudarakan	v
menantu	n
bermenantu	v
bermenantukan	v
hormat	a|n
berhormat	v
berhormat-hormat	v
menghormat	v
menghormati	v
hormat-menghormati	v
terhormat	a
penghormat	n
penghormatan	n
kehormatan	n
keramat	a
mengeramatkan	v
kekeramatan	n
ludah	n
berludah	v
meludah	v
meludahi	v
meludahkan	v
peludahan	n
serta	p
keringat	n
berkeringat	v
mengeringatkan	v
beri	v
memberi	v
beri-memberi	v
memberikan	v
berian	n
pemberi	n
pemberian	n
berkat	n|v
memberkati	v
pemberkatan	n
keberkatan	n
kaya	a
memperkaya	v
terkaya	a
kekayaan	n
damba	a
mendambakan	v
pendamba	n
sejahtera	a
kesejahteraan	n
adil	a
peradilan	n
pengadilan	n
keadilan	n
berkeadilan	v
hijau	n|a
menghijau	v
menghijaukan	v
hijauan	n
penghijau	n
penghijauan	n
kehijau-hijauan	a
biru	n|a
membiru	v
membirukan	v
kebiru-biruan	a
pucuk	n
berpucuk	v
senapan	n
bersenapan	v
arah	n
berarah	v
mengarah	v
mengarahkan	v
terarah	v
arahan	n
pengarah	n
pengarahan	n
keterarahan	n
searah	n
menyearahkan	v
penyearah	n
harap	v|n|adv
harap-harapan	v
berharap	v
berharapan	v
mengharap	v
terharap-harap	v
harapan	n
pengharapan	n
berpengharapan	v
cinta	a
bercinta	v
bercinta-cintaan	v
bercintakan	v
mencinta	v
mencintai	v
mencintakan	v
tercinta	v
percintaan	n
pencinta	n
kecintaan	n|v
rumah	n
berumah	v
berumahkan	v
merumahkan	v
rumah-rumahan	n
perumahan	n
memperumahkan	v
serumah	n
menyerumahkan	v
punah	a
mawar	n
jejak	n
berjejak	v
menjejak	v
menjejaki	v
menjejakkan	v
penjejak	n
merangkumkan	v
rangkuman	n
rangkum	v
merangkum	v
pasang	n
berpasang	v
berpasang-pasang	num
berpasang-pasangan	v
pasangan	n
sepasang	n|a
apalagi	p
enyah	v
mengenyahkan	v
gaduh	a
pergaduhan	n
penggaduhan	n
kegaduhan	n
sekarat	a
tahun	n
menahun	v
bertahun-tahun	num
tikai	n
bertikai	v
tikaian	n
pertikaian	n
perang	n
berperang-perangan	v
memerangi	v
peperangan	n
berperang	v
pelanting	v
terpelanting	v
buntu	v
kebuntuan	n
lain	a
berlainan	v
berlain-lainan	v
melaini	v
melainkan	v|p
perlainan	n
memperlain	v
memperlainkan	v
kelainan	n
berkelainan	v
bisu	a
berbisu	v
membisu	v
berserakan	v
terserak	v
serak	v
berserak	v
keluh	n
berkeluh	v
mengeluh	v
mengeluhkan	v
terkeluh	a
pengeluh	n
keluhan	n
tentang	p
bertentang	v
bertentangan	v
menentang	v
tertentang	v
tentangan	p|n
pertentangan	n
mempertentangkan	v
penentang	n
setentang	p
naik	v
menaik	v
menaiki	v
penaikan	n
kenaikan	n
menaikkan	v
tarik	v
bertarik-tarikan	v
menarik	v
tarik-menarik	v
tertarik	v
tarikan	n
ketertarikan	n
penarik	n
penarikan	n
tenteram	a
penenteraman	n
ketenteraman	n
tepi	n
bertepi	v
bertepikan	v
mengetepikan	v
tepian	n
kecuali	p|n
berkecuali	v
mengecuali	v
mengecualikan	v
memperkecualikan	v
terkecuali	v
perkecualian	n
pengecualian	n
kekecualian	n
serpih	n
raja	n
beraja	v
beraja-raja	v
meraja	v
kediaman	n
tangan	n
tangan-tangan	n
bertangan	v
tangan-menangan	n
menangani	v
tertangani	v
tanganan	n
penanganan	n
besi	n
membesi	v
bual	n
berbual	v
berbual-bual	v
membualkan	v
bualan	n
pidato	n
berpidato	v
kumal	a
pedih	a
kepedihan	n|a
bila	pron|p
bila-bila	adv
sengsara	n|a
kesengsaraan	n
teman	n
berteman	v
pertemanan	n
peneman	v
kawan	n
berkawan	v
kawanan	n
perkawanan	n
haru	n
mengharu	v
mengharukan	v
terharu	v
keterharuan	n
keharuan	n
sendu	a
bersendu	v
kesenduan	n
samar	a
menyamar	v
samaran	n
kesamaran	n
samar-samar	a
ia	n
penyamar	n
sempit	a
bersempit-sempit	v
menyempit	v
sempitan	n
persempitan	n
mempersempit	v
kesempitan	a|n
gelanggang	n
bergelanggang	v
menggelanggang	v
senak	a
menyenak	v
menyenak-nyenak	v
tersenak	v
kesenakan	v
kesenak-senakan	v
raga	n
meraga	a
terkecewa	v
kekecewaan	n
kecewa	v
mengecewakan	v
hibuk	a
kehibukan	n
gari	n
menggari	v
lolong	n
melolong	v
melolong-lolong	v
terlolong	v
terlolong-lolong	v
raung	n
meraung	v
meraung-raung	v
meraung-raungkan	v
raungan	n
sentak	v
menyentak	v
menyentakkan	v
tersentak	v
sentakan	n
buang	v
membuang	v
membuang-buang	v
membuangkan	v
terbuang	v
terbuang-buang	v
buangan	n
pembuangan	n
rangsang	n
berangsang	a
merangsang	v
terangsang	v
rangsangan	v
perangsang	n
siapa	pron
siapa-siapa	n
tilik	n
menilik	v
tilik-menilik	v
tilikan	n
penilik	n
selam	v|n
berselam	v
menyelam	v
terselam	v
terselami	v
penyelam	n
peselam	n
timbul	v
menimbul	v
pancar	v
berpancaran	v
memancar	v
memancarkan	v
terpancar	v
pancaran	n
pemancar	n
sepancar	n
rekah	v
merekah	v
sedan	n
bersedan-sedan	v
tersedan-sedan	v
kini	n
kekinian	n
tuai	n
menuai	v
penuai	n
penuaian	n
ketam	a
mengetam	v
mengetamkan	v
pengetam	n
belam	v
membelam	v
redam	a
redam-redam	a
meredam	v
meredamkan	v
redaman	n
peredam	n
peredaman	n
lukis	v
melukis	v
melukiskan	v
terlukis	v
terlukiskan	v
lukisan	n
pelukis	n
pelukisan	n
jari	n
menjari	v
penjarian	n
subuh	n
tabuh	n
menabuh	v
tabuhan	n
tabuh-tabuhan	n
tetabuhan	n
sepi	a
bersepi-sepi	v
kesepian	n
sunyi	a
bersunyi	v
bersunyi-sunyi	v
menyunyi	v
kesunyian	n
sekali	adv|num|n
sesekali	adv
bulan	n
berbulan	v
berbulan-bulan	n
membulan	v
membulan-bulani	v
bulanan	n
bulan-bulanan	n
tawa	n
tertawa	v
menertawakan	v
tertawaan	n
penertawaan	n
ketawa	v
menertawai	v
bintang	n
berbintang-bintang	v
membintangi	v
bintangan	n
perbintangan	n
sebintang	n
berbintang	v
cahaya	n
bercahaya	v
mencahayai	v
mencahayakan	v
pencahayaan	n
irama	n
berirama	v
mengiramakan	v
seirama	n
panggil	v
memanggil	v
memanggil-manggil	v
terpanggil	v
panggilan	n
pemanggil	n
jaya	a
berjaya	v
keberjayaan	n
menjayakan	v
kejayaan	n
remang	n
meremang	v
meremangkan	v
panji	n
panji-panji	n
alpa	a
mengalpakan	v
teralpa	a
kealpaan	n
bisik	n
berbisik	v
berbisik-bisik	v
membisiki	v
membisikkan	v
bisikan	n
pembisik	n
pembisikan	n
setan	
menyetan	v
persetan	p
mempersetan	v
mempersetankan	v
kesetanan	v
reda	v
bereda	v
mereda	v
meredakan	v
darah	n
berdarah	v
mendarah	v
mendarahi	v
pendarah	n
perdarahan	n
pendarahan	n
debur	n
berdebur	v
mendebur	v
gemuruh	a
bergemuruh	a
menggemuruh	v
kegemuruhan	n
jatuh	v
menjatuhkan	v
kelopak	n
berkelopak	v
mengelopak	v
terkelopak	v
tutup	n|v
bertutup	v
menutup	v
penutup	n
tutupan	n
tertutup	v
berat	a|v|n
berberat	v
memberati	v
memberatkan	v
memperberat	v
pemberat	n
pemberatan	n
keberatan	n|a|v
berkeberatan	v
layar	n
berlayar	v
melayari	v
melayarkan	v
pelayar	n
pelayaran	n
berpelayaran	adv
ulik	v
mengulik	v
kelam	a
mengelamkan	v
kekelaman	n
pengelaman	n
tetapi	p
layang	n
layang-layang	n
melayang	v
melayang-layang	v
melayangkan	v
dilayangkan	v
terlayang	v
terlayang-layang	v
layangan	n
selayang	n
awang-awang	n
awang-gemawang	n
mengawang	v
awangan	n
perawangan	n
mendendangkan	v
pendendang	n
dendang	v
berdendang	v
seni	a
pinta	n
berpinta	v
terpinta	v
kuta	v
berkuta	v
buta	a
membuta	v
membutakan	v
kebutaan	n
tuntun	v
bertuntun	v
menuntun	v
penuntun	n
tuntunan	n
pimpin	v
berpimpin	v
memimpin	v
terpimpin	v
pimpinan	n
pemimpin	n
kepemimpinan	n
maju	v|a
memaju	v
memajukan	v
pemajuan	n
kemajuan	n
mundur	v
memundurkan	v
pemunduran	n
kemunduran	n
daya	n
berdaya	v
memberdayakan	v
teperdaya	v
perdayaan	n
memperdaya	v
memperdayakan	v
pemberdayaan	n
runtuh	v
meruntuh	v
meruntuhkan	v
reruntuhan	n
runtuhan	n
keruntuhan	n|v
ripuk	a
mereka-reka	v
reka-reka	n
rekaan	n
reka-rekaan	n
reka	v
mereka	v
lapang	a
berlapang-lapang	a
melapangi	v
melapangkan	v
lapangan	n
memperlapang	v
memperlapangkan	v
tuli	a
ketulian	n
kelu	a
terkelu	v
tegun	v
bertegun	v
menegun	v
tertegun	v
tertegun-tegun	v
tebas	v
menebas	v
tebasan	n
benar	a
benar-benar	a
berbenar	v
berbenar-benar	v
membenar	v
membenar-benar	v
membenari	v
membenar-benari	v
membenarkan	v
terbenar	a|v
benaran	n
pembenaran	n
memperbenar	v
kebenaran	n
sebenarnya	adv
salah	a
salah-salah	p
bersalah	v
bersalahan	v
bersalah-salahan	v
menyalah	v
tersalah	v
mempersalahkan	v
kesalahan	n
hampir	adv
hampir-hampir	adv|v
menghampiri	v
hampirkan	v
menghampirkan	v
tumpah	v
tertumpah	v
tumpahan	n
pertumpahan	n
ketumpahan	v
pintu	n
insaf	a|n
menginsafi	v
menginsafkan	v
keinsafan	n
durhaka	a
berdurhaka	v
mendurhaka	v
mendurhakai	v
pendurhaka	n
pendurhakaan	n
gugur	v
berguguran	v
menggugurkan	v
guguran	n
pengguguran	n
keguguran	n
sungkur	v
menyungkur	v
tersungkur	v
lipur	v
melipur	v
melipurkan	v
pelipur	n
buat	v
buat-buatan	n
berbuat	v
terbuat	v
buatan	n
perbuatan	n
pembuatan	n
mungkin	adv
memungkinkan	v
kemungkinan	n
ibu	n
beribu	v
keibuan	a
marah	a
marah-marah	v
memarahi	v
memarahkan	v
marahan	v
pemarah	n
kemarahan	n
kemarah-marahan	a
merajuki	v
perajuk	n
rajuk	v
merajuk	v
pilu	a
berpilu	v
kepiluan	n
kepilu-piluan	n
peduli	v
memedulikan	v
kepedulian	n
walaupun	p
bibir	n
masam	a
memasam	v
kemasam-masaman	a
laku	n|a
berlaku	v
keberlakuan	n
pemberlakuan	n
memberlakukan	v
melakukan	v
lakuan	n
perlakuan	n
memperlakukan	v
pelaku	n
kelakuan	n
selaku	p
turut	v
menurut	v|p
menurutkan	v
memperturutkan	v
memperturut-turutkan	v
penurut	n
songsong	v
bersongsong	v
menyongsong	v
juga	adv
marak	a|n
memarak	v
memarakkan	v
semarak	a
bersemarak	v
jilat	v
menjilat	v
menjilat-jilat	v
jilatan	n
penjilat	n
penjilatan	n
lonjak	n
melonjak	v
melonjak-lonjak	v
terlonjak	v
pelonjakan	n
jahanam	a|v|n
menjahanamkan	v
neraka	n
menerakakan	v
melambai	v
melambai-lambai	v
melambaikan	v
melambai-lambaikan	v
lambaian	n
lambai	v
berlambai-lambai	v
lengkung	a
melengkung	v
melengkungi	v
melengkungkan	v
terlengkung	v
lengkungan	n
pelengkung	n
kelengkungan	n
lurus	a
melurus	v
meluruskan	v
kelurusan	n
berselurus	v
selurusan	n
selurusnya	adv
ria	a
beria	v
beria-ria	v
keriaan	n
belah	n|v
berbelah	v
berbelah-belah	v|a
berbelahan	v|n
membelah	v
belahan	n
pembelah	n
pembelahan	n
sebelah	n
menyebelah	v
sebelah-menyebelah	n
menyebelahi	v
menyebelahkan	v
bersebelahan	v
firdausi	a
segera	adv
bersegera	v
mempersegera	v
mepersegerakan	v
persegeraan	n
sesegera	adv
murtad	v
memurtadkan	v
pemurtadan	n
kemurtadan	n
rentak	n
merentak	v
serentak	a
menyerentakkan	v
topan	n
kabut	a|n
berkabut	v|a
pengabut	n
utama	a
mengutamakan	v
terutama	a
pengutamaan	n
keutamaan	n
jantung	n
berjantung	v
menjantung	v
jantungan	v
lebur	a
melebur	v
meleburkan	v
terlebur	adv
leburan	n
peleburan	n
kering	a
berkering	v
mengering	v
mengeringi	v
mengeringkan	v
pengering	n
pengeringan	n
kekeringan	n
minta	
minta-minta	v|adv
berminta	v
berminta-minta	v
meminta	v
meminta-minta	v
memintai	v
memintakan	v
permintaan	n
peminta	n
peminta-minta	n
hujan	n
berhujan	v
berhujan-hujan	v
menghujan	v
menghujani	v
menghujankan	v
menghujan-hujankan	v
memperhujankan	v
kehujanan	v
embun	n
berembun	v
mengembun	v
mengembuni	v
mengembunkan	v
memperembunkan	v
pengembun	n
pengembunan	n
embunan	n
rahmat	n
padam	a
pemadam	n
kepadaman	n|v
pulih	v
pokok	n
berpokok	v
teratak	n
meneratak	v
bambu	n
lampau	a|adv
melampau	v
melampaui	v
terlampau	adv|v
terlampaui	v
kelampauan	v
susup	v
menyusup	v
menyusupkan	v
susupan	n
penyusup	n
penyusupan	n
kesusupan	v
lubang	n
berlubang	v
berlubang-lubang	v
melubangi	v
pelubang	n
pelubangan	n
tepas	n
bertepas	v
menepas	v
kayu	n
kayu-kayuan	n
kekayuan	n
perkayuan	n
berkayu	v
puncak	n
memuncak	v
pemuncak	n
arak	v
berarak	v
berarakan	v
berarak-arakan	v
arakan	n
arak-arakan	n
perarakan	n
payung	n
berpayung	v
jemala	n
bapa	n
manja	a
bermanja-manja	v
memanjakan	v
termanja-manja	v
mempermanjakan	v
kemanjaan	n
kemanja-manjaan	a
bena	n
terada	n
lagak	n
berlagak	v
melagak	v
melagakkan	v
pelagak	n
sangkak	n
bersangkak	v
sesangkak	n
telur	n
bertelur	v
menelur	v
perteluran	n
petelur	n
lauk	n
lauk-pauk	n
berlauk	v
sejuk	a
bersejuk	v
bersejuk-sejuk	v
menyejuk	v
penyejuk	n
kesejukan	n|v
lasak	a
pelasak	n
sabak	a
menyabak	v
guling	v
berguling	v
bergulingan	v
mengguling	v
menggulingkan	v
terguling	v
terguling-guling	v
lemah	a
melemahkan	v
memperlemahkan	v
kelemahan	n
sayup	a
sayup-sayup	adv
sayup-menyayup	adv
sesayup-sayup	adv
pecah	v
berpecah	v
berpecahan	v
memecah	v
memecahkan	v
terpecah	v
terpecah-pecah	v
pecahan	n
perpecahan	n
pemecah	n
pemecahan	n
kepecahan	n
rupa	n
rupa-rupa	a
berupa	v
berupa-rupa	v
merupa	v
merupai	v
merupakan	v
perupa	n
terupa	v
serupa	n
berserupa	v
menyerupa	v
menyerupai	v
menyerupakan	v
perserupaan	n
keserupaan	n
rupanya	adv
rupa-rupanya	adv
rangkup	n
merangkup	v
tangkup	n
bertangkup	v
menangkup	v
menangkupkan	v
tertangkup	v
setangkup	n
ngeri	a
mengerikan	v
kengerian	n
bunyi	n
berbunyi	v
membunyikan	v
bunyi-bunyian	n
pembunyian	n
sebunyi	n
lupa	v|a
melupai	v
melupakan	v
terlupa	v
lupa-lupaan	v|a
pelupa	n
kelupaan	n|v
tangis	n
bertangisan	v
bertangis-tangisan	v
menangis	v
menangisi	v
menangiskan	v
tangisan	n
mempertangis	v
penangis	a|n
begini	pron
membeginikan	v
beginian	n
sebegini	num
susah	a
bersusah	v
bersusah-susah	v
mempersusah	v
kesusahan	v|n
telan	v
menelan	v
tertelan	v
tampar	v
bertampar	v
menampar	v
menampari	v
menamparkan	v
tamparan	n
sorak	n
bersorak	v
penyorak	n
semarai	a
sahut	n
bersahut	v
bersahutan	v
bersahut-sahutan	v
menyahut	v
sahut-menyahut	v
menyahuti	v
sahutan	n
penyahut	n
penyahutan	n
sambil	p
tersambil	v
sambilan	n
sedu	n
bersedu	v
bersedu-sedu	v
tersedu-sedu	v
langsing	a
melangsingkan	v
pelangsing	n
kelangsingan	n
mandi	v
bermandi	v
bermandikan	v
memandikan	v
permandian	n
mempermandikan	v
pemandian	n
takut	a
takut-takut	adv
menakut	v
takut-takutan	a
mempertakut	v
penakut	n|a
ketakutan	n|a
berketakutan	v
demikian	pron
sedemikian	pron
janji	n
berjanji	v
menjanjikan	v
perjanjian	n
bangkit	v
berbangkit	v
membangkit	v
membangkit-bangkit	v
membangkitkan	v
terbangkit	v
bangkitan	n
pembangkit	n
kebangkitan	n
pelan	a
pelan-pelan	v
memelankan	v
tambah	n
bertambah	v
bertambah-tambah	v
menambah	v
menambahi	v
menambahkan	v
tambahan	n
pertambahan	n
penambah	n
penambahan	n
kuat	a
kuat-kuat	adv
berkuat	v
berkuat-kuat	v
berkuat-kuatan	v
memperkuat	v
kekuatan	n
sekuat	n
sekuat-kuatnya	adv
cepat	a
cepat-cepat	adv
bersicepat	v
bercepat-cepat	v
mencepat	v
mencepatkan	v
mempercepat	v
pemercepat	n
percepatan	n
pencepatan	n
kecepatan	n
berkecepatan	v
secepat	a
bersecepat	v
secepatnya	adv
lenyap	a
melenyapkan	v
kelenyapan	n
bimbang	a
membimbangkan	v
kebimbangan	n
tanya	n|v
bertanya	v|a
menanya	v
menanyai	v
menanyakan	v
mempertanyakan	v
pertanyaan	n
penanya	n
penanyaan	n
lekas	adv
lekas-lekas	a
berlekas-lekas	adv
berlekas-lekasan	v
melekaskan	v
memperlekas	v
selekasnya	adv
selekas-lekasnya	adv
pantas	a
memantas	v
pemantas	n
sepantasnya	adv
sisi	n
bersisi	v
bersisian	v
mengesisikan	v
lompat	v
berlompatan	v
melompat	v
melompat-lompat	v
melompati	v
melompatkan	v
terlompat	v
lompatan	n
pelompat	n
sepelompat	n
sepelompatan	n
mangsa	n
memangsa	v
pemangsa	n
katup	n
mengatup	v
mengatupkan	v
mengatup-ngatupkan	v
memperkatupkan	v
terkatup	v
tulang	n
bertulang	v
tertulang	v
tulang-tulangan	adv|n
pertulangan	n
ketulangan	n
menulang	v
belulang	n
berbelulang	v
pula	p
maut	n|a
permautan	n
lebar	a|n
melebar	v
melebarkan	v
memperlebar	v
pelebaran	n
selebar	v
pangah	v
terpangah	v
riang	a
meriangkan	v
periang	n
keriangan	n
cap	n
mengecap	v
mengecapkan	v
pengecapan	n
sedap	a
sedapan	n
sedap-sedapan	n
penyedap	n
kesedapan	n
taruh	n
bertaruh	v
bertaruhan	v
menaruh	v
menaruhkan	v
taruhan	n
pertaruhan	n
petaruh	n
mempertaruhkan	v
berpetaruh	v
petaruhan	n
berpenaruhan	v
menaruhi	v
hamba	n
berhamba	v
menghamba	v
menghambai	v
menghambakan	v
penghambaan	n
memperhamba	v
memperhambakan	v
perhambaan	n
penghulu	n
halus	a
menghalusi	v
menghaluskan	v
memperhalus	n
kehalusan	n
pohon	n
pepohonan	n
pohon-pohonan	n
rindang	a
merindang	v
perindang	n
teduh	a
berteduh	v
berteduhkan	v
meneduh	v
perteduhan	n
peneduh	n
keteduhan	n
meriang	a
tangga	n
bertangga	v
setangga	n
kecapi	n
telinga	n
bertelinga	v
menelinga	v
sentuh	v
bersentuh	v
bersentuhan	v
menyentuh	v
menyentuh-nyentuh	v
menyentuhkan	v
tersentuh	v
sentuhan	n
persentuhan	n
penyentuh	n
penyentuhan	n
kesentuhan	v
gambuh	n
bergambuh	v
kandil	n
cempaka	n
duniawi	a
keduniawian	n
lambung	n
melambung	v
melambungi	v
memalingkan	v
palingan	n
paling	v
berpaling	v
poyang	n
rata	a
rata-rata	a
merata	v
meratai	v
meratakan	v
memeratakan	v
merata-ratakan	v
pemerataan	n
serata	num
menyeratakan	v
petik	v
memetik	v
memetiki	v
memetikkan	v
terpetik	v
petikan	n
pemetik	n
pemetikan	n
rebana	n
berebana	v
suling	n
menyuling	v
celah	n
bercelah	v
genta	n
menggenta	v
genderang	n
puji	n
memuji	v
memujikan	v
pemuji	n
pemujian	n
mercu	n
menari	v
tari-menari	n
menarikan	v
penari	n
doa	n
berdoa	v
mendoa	v
mendoakan	v
cabang	n
bercabang	v
bercabang-cabang	v
mencabang	v
mencabangkan	v
percabangan	n
mempercabangkan	v
pencabangan	n
kesturi	n
terlayah	v
layah	v
melayah	v
intip	v
mengintip	v
sunting	n
bersunting	v
bersuntingkan	v
suntingan	n
mempersunting	v
jati	a
sejati	a
kesejatian	n
taman	n
pertamanan	n
kuntum	n
menguntum	v
terkuntum	v
tegak	a
tegak-tegak	a
bertegak	v
menegak	a
penegak	n
tertegak	v
tegakan	n
setegak	a
sepertegak	adv
ketegakan	n
wangi	a
wangi-wangian	n
wewangian	n
mewangi	v
mewangikan	v
pewangi	n
kewangian	a|n
kewangi-wangian	a
pipi	n
daun	n
berdaun	v
mendaun	adv
daun-daunan	n
dedaunan	n
lunak	a
melunak	v
melunaki	v
melunakkan	v
memperlunak	v
pelunak	n
pelunakan	n
kelunakan	n
cengang	a
bercengangan	v
bersicengang	v
mencengangkan	v
tercengang	v
tercengang-cengang	v
barat	n
membaratkan	v
baratan	n
pembarat	n
pembaratan	n
kebarat-baratan	a
timur	n
menimur	v
ketimuran	n
guru	n
berguru	v
menggurui	v
perguruan	n
keguruan	n
muslim	n
hindu	n
berhindu	v
Kristen	n
mengkristenkan	v
kekristenan	n
Buddha	n
ikut	v
ikut-ikut	v
berikut	v|n
mengikut	v
mengikuti	v
mengikutkan	v
ikutan	n
ikut-ikutan	v
terikut	v
memperikut	v
memperikutkan	v
pengikut	n
taocang	n
saleh	n
kesalehan	n
berani-berani	a
berberani-berani	v
memberanikan	v
terberanikan	v
pemberani	n
tikar	n
sembahyang	n
bersembahyang	v
sembahyangan	n
persembahyangan	n
pelana	n
berpelana	v
memelana	v
arasy	n
laocu	n
howitzer	n
Almasih	n
Muhammad	n
Rasulullah	n
masjid	n
permasjidan	n
khidmat	a
berkhidmat	v
kekhidmatan	n
walau	p
sebab	n|p
bersebab	v
tersebab	v
penyebab	n
kepak	n
berkepak	v
berkepak-kepak	v
mengepak-ngepak	v
mengepak-ngepakkan	v
terkepak-kepak	v
sari	n
lakon	n
lelakon	n
berlakon	v
melakoni	v
melakonkan	v
pelakon	n
kelar	n
berkelar	v
berkelar-kelar	v
mengelar	v
siuman	n
tukar	v
bertukar	v
bertukar-tukar	v
bertukaran	v
bertukar-tukaran	v
menukar	v
tukar-menukar	v
menukari	v
menukarkan	v
tertukar	v
pertukaran	n
mempertukarkan	v
penukar	n
penukaran	n
datar	a
mendatar	v
mendatarkan	v
dataran	n
pendataran	n
sedatar	a
wayang	n
mewayangkan	v
wayangan	n
pewayang	n
pewayangan	n
warna	n
berwarna	v
berwarna-warna	v
mewarnai	v
mewarnakan	v
pewarna	n
pewarnaan	n
sewarna	n
tayang	v
menayang	v
menayangkan	v
tertayang	v
sukma	n
he	
lima	num
berlima	num
seperlima	num
lebih	a
berlebih	v|a
berlebih-lebih	a
melebih	v
melebihi	v
melebih-lebihi	v
terlebih	adv
terlebih-lebih	adv
sekarang	n
hasrat	n
berhasrat	v
menghasratkan	v
terhasrat	v
kehasratan	n
mengidam	v
idaman	n
idam	n
kawi	n
datuk	n
berdatuk	v
hujung	n
penghujung	n
kehujungan	v
lidah	n
berlidah	v
melidahkan	v
piatu	n
kepiatuan	n
teruna	n
tengah	n
menengah	v|a
mengetengahi	v
mengetengahkan	v
tengahan	n
pertengahan	n|a
penengah	n
setengah	num
setengah-setengah	adv
gembala	n
menggembalakan	v
penggembala	n
penggembalaan	n
duka	a
berduka	v
kedukaan	n
mendukai	v
mendukakan	v
sapu	n
tersapu	v
sapuan	n
pigura	n
nilam	n
hitam	n|a
menghitam	v
menghitami	v
menghitamkan	v
penghitam	n
penghitaman	n
kehitaman	a
kehitam-hitaman	a
alit	n
mengalit	v
seratus	num
seperatus	num
seperseratus	num
tekan	v
bertekan	v
menekankan	v
tertekan	v
tertekan-tekan	v
tekanan	n
penekan	n
penekanan	n
bersetekan	v
menekan	v
nipis	n
melindungi	v
melindungkan	v
terlindung	v
lindungan	n
perlindungan	n
memperlindungi	v
pelindung	n
pelindungan	n
kelindungan	v
lindung	v
berlindung	v
dawai	n
berdawai	v
pesawat	n
berpesawat	v
sungkum	v
menyungkum	v
tersungkum	v
suci	a
bersuci	v
persucian	n
kesucian	n
pelangi	n
singgung	v
bersinggungan	v
menyinggung	v
tersinggung	v
persinggungan	n
menghantar	v
menghantarkan	v
terhantar	v
hantar	v
berhantaran	v
hauri	n
kapak	n
canggai	n
telangkai	n
menelangkai	v
urat	n
berurat	v
tunjang	v
menunjang	v
tertunjang	v
penunjang	n
tunjangan	v
acara	n
beracara	v
mengacara	v
mengacarakan	v
pengacara	n
kepengacaraan	n
kepetahan	n
petah	v
memetahkan	v
fasih	a
memfasihkan	v
memperfasih	v
kefasihan	n
hadap	n|v
berhadap-hadapan	v
menghadap	v
terhadap	p
hadapan	n
penghadapan	n
bersehadap	v
lawan	n|v
berlawan	v
berlawanan	v
melawan	v
melawani	v
melawankan	v
terlawan	v
perlawanan	n
memperlawankan	v
pelawan	n
kelawanan	n
tongkat	n
bertongkat	v
menongkat	v
penongkat	n
kunci	n
mengunci	v
menguncikan	v
terkunci	v
pengunci	n
ratu	n
pukul	n|v|a
pukul-memukul	v
terpukul	v
pukulan	n
memperpukuli	v
memperpukulkan	v
pemukul	n
memukul	v
sembilan	num
bersembilan	v
kesembilan	n
kesembilannya	n
lecut	n
melecut	v
melecutkan	v
pelecut	n
kanti	n
penganti	n
asli	n
keaslian	n
main	v
bermain	v
mainan	n
main-mainan	n
permainan	n
sepermainan	n
bagaimana	pron
sebagaimana	p
timbang	a
bertimbang	v
bertimbangan	v
menimbang	v
menimbang-nimbang	v
timbang-menimbang	v
menimbangi	v
menimbangkan	v
timbangan	n
penimbang	n
penimbangan	n
pertimbangan	n
mempertimbangkan	v
setimbang	a
menyetimbangkan	v
setimbangan	a
kesetimbangan	n
tubir	n
penaka	p
durjana	a|n
kedurjanaan	n
tanda	n
bertanda	v
bertanda-tandaan	v
tertanda	v
pertanda	n
pertandaan	n
penanda	n
telaga	n
tali	n
bertali	v
tali-bertali	v
bertali-tali	v
bertalian	v
pertalian	n
mempertalikan	v
simpul	n
menyimpul	v|a
tersimpul	v
simpulan	n
kesimpulan	n
berkesimpulan	v
niat	n
berniat	v
berniat-niat	v
meniatkan	v
terniat	v
terbang	v
beterbangan	v
menerbangi	v
menerbangkan	v
penerbang	n
penerbangan	n
ungkaian	n
ungkai	v
mengungkai	v
karam	v
mengaram	v
rampak	a
lintang	n
melintang	v
melintangi	v
melintangkan	v
terlintang	v
lintangan	n
pukang	n
memukang-mukang	v
lari	v|n
lari-lari	v
berlari	v
berlari-lari	v
berlarian	v
berlari-larian	v
melarikan	v
larian	n
pelari	n
pelarian	n
sepelarian	n
selari	adv
tumbang	v
purba	a
kepurbaan	n
terika	v
menerika	v
riuh	a
belam	a
terbelam	v
gagap	n
bergagap-gagap	v
tergagap-gagap	v
menggagap	v
gempita	a
menggempita	a
guruh	n
mengguruh	v
kilau	n
berkilau	v
berkilauan	a
berkilau-kilauan	v
mengilau	v
kilau-mengilau	v
kilauan	n
kilat	n
berkilat	v
berkilat-kilat	v
berkilatan	v
mengilat	v|a
terkilat	v
kilatan	n
julang	v
menjulang	v
apung	v
apung-apung	n
berapung-apung	v
berapungan	v
mengapung	v
mengapungkan	v
terapung	v
terapung-apung	v
terbebas	v
pembebas	n
pembebasan	n
kebebasan	n
bebas	v
membebaskan	v
lepas	a
berlepas	v
melepas	v
melepasi	v
melepaskan	v
terlepas	v
lepasan	n
memperlepas	v
pelepas	n
pelepasan	n
kelepasan	n
selepas	p
selepas-lepas	adv
melelangkan	v
memperlelangkan	v
pelelangan	n
lelang	v
melelang	v
perlelangan	n
menyemayamkan	v
persemayaman	n
semayam	v
bersemayam	v
intan	n
bunda	n
kami	pron
pangkai	a
jauhari	n
ahli	n|a
berkeahlian	v
mengahlikan	v
keahlian	n
lalai	a|v
berlalai-lalai	v
melalaikan	v
terlalai	v|a
terlalaikan	v
memperlalaikan	v
pelalai	n
pelalaian	n
kelalaian	n
lengah	a|v
berlengah-lengah	v
melengah	a|v
melengah-lengah	v
melengahkan	v
memperlengah	v
memperlengah-lengah	v
memperlengah-lengahkan	v
terlengah	v|a
pelengah	n
kelengahan	n
langsung	adv|v
berlangsung	v
melangsungkan	v
terlangsung	v
perlangsungan	n
kelangsungan	n
keberlangsungan	n
abad	n
berabad-abad	v
guna	n
berguna	v
menggunakan	v
mempergunakan	v
pengguna	n
penggunaan	n
kegunaan	n
seguna	n
tunggu	v
bertunggu	v
menunggu	v
penunggu	n
berlena-lena	v
terlena	v|a
kelenaan	n
lena	v
berlena	v
alis	n
junjung	v
menjunjung	v
berjunjungan	v
menjunjungkan	v
junjungan	n
menyelendang	v
memperselendang	v
memperselendangkan	v
selendang	v
berselendang	v
tirus	a
menirus	v
asmara	n
berasmara	v
lampai	a
melampai	v
terlampai	v
ramping	a
meramping	v
merampingkan	v
mari	p
banting	v
membanting	v
membantingkan	v
bantingan	n
pembantingan	n
ketuk	n
mengetuk	v
terketuk	v
ketukan	n
pengetuk	n
hendak	adv
menghendaki	v
hendaklah	adv
kehendak	n
berkehendak	v
sekehendak	adv
belan	n
bujang	n
membujang	v
bujangan	n
pembujangan	n
kebujangan	n
siku	n
siku-siku	n
bersiku	v
sapa	n
bersapa	v
disapa	v
tersapa	v
perlahan	a
perlahan-lahan	a
memerlahan	v
memerlahankan	v
sayu	a
kesayuan	n
rayu	a
merayu	v
merayukan	v
pujuk	n
memujuk	v
terpujuk	v
campur	v
bercampur	v
bercampuran	v
mencampur	v
mencampuri	v
mencampurkan	v
tercampur	v
campuran	n
percampuran	n
pencampuran	n
bangsi	n
dayu	v
mendayu	v
memencilkan	v
terpencil	v
keterpencilan	n
pemencilan	n
pencil	v
memencil	v
topang	n
bertopang	v
bertopangkan	v
menopang	v
topangan	n
penopang	n
dagu	n
kecup	n|v
mengecup	v
kecupan	n
sementara	p|n|num
kesementaraan	n
teja	v
pendar	n
berpendar	v
berpendar-pendar	v
pendaran	n
berpendaran	v
imbau	v
mengimbau	v
terimbau	v
imbauan	n
pengimbauan	n
sembah	n
menyembah	v
mempersembahkan	v
penyembah	n
menyembahkan	v
kesumba	n
mengesumba	v
padang	n
berpadang	v
tayangan	n
penayangan	n
sela	n
sela-sela	n
bersela	v
sela-menyela	v
rapuh	a
merapuhkan	v
perapuh	n
kerapuhan	n
gurau	n
bergurau	v
mengguraukan	v
gurauan	n
pergurauan	n
memperguraukan	v
kelana	n
berkelana	v
mengelana	v
pengelana	n
memberai-beraikan	v
berai	a
berberaian	a
bujuk	n
membujuk	v
membujuki	v
bujukan	n
pembujuk	n
pembujukan	n
simpai	n
bersimpai	v
menyimpai	v
tersimpai	v
bisai	a|n
malu	a
malu-malu	a
bermalu	v
memalui	v
memalukan	v
mempermalukan	v
pemalu	n
kemaluan	v|n
kemalu-maluan	a
rumput	n
berumput	v
merumput	v
merumputi	v
perumputan	n
rerumputan	n
rumput-rumputan	n
rendah	a
merendah	v
merendahkan	v
rendahan	n
kerendahan	a|v
lembah	n
melur	n
sepoi	a
pelik	a
pelikan	n
kepelikan	n
tangkai	n
serah	v
berserah	v
menyerahi	v
menyerahkan	v
terserah	v|a
serahan	n
seserahan	n
penyerahan	n
menyerah	v
jemu	a
menjemukan	v
jemuan	n
kejemuan	n
mengata	v
mengatakan	v
cendera	n
dagang	n
berdagang	v
mendagangkan	v
memperdagangkan	v
dagangan	n
pedagang	n
perdagangan	n
adu	v
mengadu	v
mengadukan	v
memperadukan	v
pengadu	n
jumpa	v
berjumpa	v
menjumpai	v
terjumpa	v
perjumpaan	n
apatah	pron
untung	n|a
untung-untung	adv
beruntung	v
beruntung-untung	v
keberuntungan	n
menguntungkan	v
untung-untungan	a
peruntungan	n
keuntungan	n
seberuntung-beruntungnya	a
luka	n|v
melukai	v
terluka	v
perlukaan	n
pelukaan	n
cerai	v
berceraian	v
mencerai	v
perceraian	n
penceraian	n
sembuh	v
penyembuh	n
kesembuhan	n
garing	a
jampi	n
jampi-jampi	n
berjampi	v
menjampi	v
menjampikan	v
jampian	n
mohon	v
memohon	v
memohonkan	v
pemohon	n
kemala	n
bukan	adv|pron|a
berbukan	v
bukankah	pron
ubah	v
berubah	v
berubah-ubah	v
mengubah	v
mengubahkan	v
terubah	v
ubahan	n
peubah	n
perubah	n
perubahan	n|v
pengubah	n
pengubahan	n
dahulu	n
dahulu-mendahului	v
bersidahulu	v
berdahulu-dahuluan	v
mendahului	v
mendahulukan	v
terdahulu	a
pendahulu	n
pendahuluan	n
kedahuluan	v
rahim	n
membubungkan	v
memperbubungkan	v
kudus	a
kekudusan	a
tenang	a
bertenang-tenang	v
menenang	v
penenang	n
benang	n
berbenang-benang	v
membenang	v
sebentar	n
sebentar-sebentar	adv
daerah	
kedaerahan	n
bakal	n|adv|p
membakal	v
membakalkan	v
bakalan	v
pembakalan	n
selain	p
menghuni	v
menghunikan	v
hunian	n
penghuni	n
berpenghuni	v
penghunian	n
terhuni	v
huni	v
berhuni	v
moga-moga	adv
betah	a
membetahkan	v
sedang	p
sedangkan	p
derita	n
menderita	v
deritaan	n
penderita	n
penderitaan	n
cemas	a
kecemasan	n|a
sesat	a
bersesat	a
menyesatkan	v
tersesat	v
kesesatan	n
penyesatan	n
sandang	n
menyandang	v
menyandangkan	v
mempersandangkan	v
penyandang	n
kutuk	n
mengutuk	v
terkutuk	v
kutukan	n
keterkutukan	n
kampung	n|a
berkampung	v
mengampung	v
kampungan	a
perkampungan	n
halaman	n
sangka	v|n
bersangka	v
menyangka	v
tersangka	v
sangkaan	n
sempurna	a
kesempurnaan	n
sinau	a
bersinau-sinau	a
tunjung	n
berahi	n|a
memberahikan	v
keberahian	n
tangkap	v
bertangkap	v
menangkap	v
tertangkap	v
tangkapan	n
penangkap	n
ketangkapan	v
ayun	n
ayun-temayun	v
berayun	v
berayun-ayun	v
mengayun	v
mengayunkan	v
ayunan	n
warna-warni	n
berwarna-warni	v
mewarna-warnikan	v
tunjuk	v
bertunjuk-tunjukan	v
menunjuk	v
tunjuk-menunjuk	v
menunjuki	v
menunjukkan	v
pertunjuk	n
pertunjukan	n
mempertunjukkan	v
petunjuk	n
penunjuk	n
penunjukan	n
bentuk	n
berbentuk	v
membentuk	v
terbentuk	v
bentukan	n
pembentuk	n
pembentukan	n
suntuk	adv
tersuntuk	v
kencana	n
tunduk	v
menunduk	v
menunduk-nunduk	v
petunduk	n
ketundukan	n
ketertundukan	n
puas	a|v
kepuasan	n
sepuas-puasnya	adv
teguk	v
meneguk	v
terteguk	v
ketegukan	n
seteguk	n
segara	n
remaja	a|n
meremajakan	v
peremajaan	n
bersepah-sepah	v
tersepah	v
sepah	v
bersepah	v
kusuma	n
kucup	
mengucup	v
gulai	n
menggulai	v
menganekakan	v
keanekaan	n
penganekaan	n
aneka	a
beraneka	a
bangga	a
kebanggaan	n
sorak-sorai	n
bersorak-sorai	v
takbir	n
takbiran	n
nyali	n
bernyali	v
zalim	a
kezaliman	n
siap	v
bersiap	v
bersiap-siap	v
mempersiapkan	v
persiapan	n
tumbal	n
harga	n
berharga	v|a
menghargai	v
menghargakan	v
penghargaan	n
pertiwi	n
buai	n
berbuai	v
berbuai-buai	v
membuai	v
terbuai	v
terbuai-buai	v
buaian	n
nada	n
bernada	v
nada-nadanya	n
ingin	adv
mengingini	v
menginginkan	v
memperingin	v
keinginan	n
berkeinginan	v
setrika	n
bersetrika	v
menyetrika	v
setrikaan	n
penyetrika	n
penyetrikaan	n
linggis	n
melinggis	v
Inggris	n
menginggriskan	v
keinggris-inggrisan	a
gada	n
menggada	v
penggada	n
Belanda	n
membelandakan	v
kebelanda-belandaan	a
angkuh	a
keangkuhan	n
kotor	a
mengotori	v
pengotor	n
persada	n
harus	adv
mengharuskan	v
keharusan	n
seharusnya	adv
meski	p
meskipun	p
pahlawan	n
kepahlawanan	n
